NO ./images/wall/wood1.xpm
SO  ./images/wall/wood1.xpm
EA ./images/wall/wood2.xpm
WE ./images/wall/wood2.xpm

            111111111111111111111111111111111111111111111111111111111111111111111111111111111111111111111111111111111111111111111111111111111111111111111111111111
            100000000000000000000000000000000000000000000000000000000000000000000000000000000000000000000000000000000000000000000000000000000000000000000000000001
            100000000000000000111111111111111111111111111111111111111111111111111111111111111111111111111111111111111111111111111111111111111111111111111111011111
    11111111100010000010000000000001                                                                                                                       101
    10000000000000000010001111000001                                                                                                                       101
    10000000000000000010000001000001                                                                                                                       101
    10001000000000011011111001000001                                                                                                                       101
    10000000000000000000000001000001                                                                                                                       101
    10000000000000000000000000000001                                                                                                                       101
    10000000000000000000000000000001                                                                                                                       101
    10111111111114000W00000000000001                                                                                                                       101
    10000000000000000000000000000001                                                                                                                       101
    10001111000000000000000000000001                                                                                                                       101
111110000000000000000000000000000001                                                                                                                       101
100000000000000000000000000000000001                                                                                                                       101
111110001001000000000000000001000001                                                                                                                       101
    1000111100000000000000000000000111111111111111111111111111111111111111111111111111111111111111111111111111111111111111111111111111111111111111111111111101
    1000000000000000000100000000000000000200000000000000000000000000000000000000000000000000000000000000000000000000000000000000000000000000000000000000000001
    1011121111140000000000000000000111111111111111111111111111111111111111111111111111111111111111111111111111111111111111111111110000000001111111111111111111
    10000000000000000000000000000001                                                                                           1111111000000011111111111111111
    10001111001110000000000000000001                                                                                           1111111000000000011111111111111
    10001001001001001004001001000001                                                                                           1111111111111111111111111111111
    10001001001001001001001001000001
    10001111001110000111001111000001
    10000000000000000000000000000001
    10111111111111111111111111110001
    10000000000000000000000000000001
    10001111111111111111111111000001
    10001000000000000000000001000001
    10001000111111111111111001000001
    10000000000000000000000000000001
    11111111101111111111111111111111
            101
            101
            101
   111111111000111111111
   100000000000000000001
   100000000000000000001
   100000000000000000001
   100000000000000000001
   100000000000000000001
   100000000000000000001
   100000000000000000001
   111111111111111111111